abis	a b i s					
account	ə k a ʊ n t	
ada	a d a					
adanya	a d a ny a					
agak	a g a k					
ai	e ɪ a ɪ					
aja	a j a					
akal	a k a l					
akhiri	a kh i r i					
akses	a k s e s					
aku	a k u					
akurasinya	a k u r a s i ny a					
aman	a m a n					
amin	a m i n					
anak	a n a k					
anaknya	a n a k ny a					
apa	a p a					
api	e ɪ p i a ɪ					
approve	ə p r u v					
asesmen	a s e s m E n					
assurance	ə ʃ ʊ r ə n s					
atasan	a t a s a n					
atau	a t au					
baca	b a c a					
bagi	b a g i					
bagus	b a g u s					
bahan	b a h a n					
baik	b ai k					
bakal	b a k a l					
balik	b a l i k					
banget	b a ng E t					
bantuin	b a n t u i n					
banyak	b a ny a k					
baru	b a r u					
beberapa	b E b E r a p a					
beda	b e d a					
belas	b E l a s					
belum	b E l u m					
bener	b E n E r					
benerin	b E n E r i n					
berapa	b E r a p a					
berarti	b E r a r t i					
berikutnya	b E r i k u t ny a					
besok	b e s o k					
biasa	b i a s a					
bikin	b i k i n					
bikinnya	b i k i n ny a					
bingung	b i ng u ng					
bisa	b i s a					
boleh	b o l e h					
buat	b u a t					
bug	b u g					
bukan	b u k a n					
bulanan	b u l a n a n					
butuh	b u t u h					
cepet	c E p E t					
coba	c o b a					
cukup	c u k u p					
cuma	c u m a					
cuti	c u t i					
daftar	d a f t a r					
dan	d a n					
dari	d a r i					
data	d a t a					
database	d a t a b a s e					
databasenya	d a t a b a s e ny a					
datanya	d a t a ny a					
dateng	d a t E ng					
deh	d e h					
depan	d E p a n					
depannya	d E p a n ny a					
deteksi	d E t e k s i					
developnya	d e v e l o p ny a					
di	d i					
dibawa	d i b a w a					
dibikin	d i b i k i n					
dibuat	d i b u a t					
dibuatkan	d i b u a t k a n					
dikasih	d i k a s i h					
dikerjain	d i k E r j ai n					
dikontak	d i k o n t a k					
dikumpulin	d i k u m p u l i n					
diminta	d i m i n t a					
dipake	d i p a k e					
dipesen	d i p E s E n					
disedain	d i s E d ai n					
ditagih	d i t a g i h					
dokter	d o k t E r					
dokumentasi	d o k u m e n t a s i					
dua	d u a					
duanya	d u a ny a					
duduk	d u d u k					
dulu	d u l u					
e	E					
eh	e h					
emang	e m a ng					
empat	E m p a t					
engga	E ng g a					
engineer	e n j i n e r					
eror	e r o r					
erornya	e r o r ny a					
fitur	f i t u r					
fiturnya	f i t u r ny a					
fokus	f o k u s					
forum	f o r u m					
foto	f o t o					
ga	g a					
gampang	g a m p a ng					
gapapa	g a p a p a					
gatau	g a t au					
gila	g i l a					
gimana	g i m a n a					
gitu	g i t u					
hah	h a h					
hampir	h a m p i r					
harga	h a r g a					
hari	h a r i					
harus	h a r u s					
harusnya	h a r u s ny a					
hasilnya	h a s i l ny a					
hire	h a ɪ ə r					
hold	h o ʊ l d					
hotel	h o t e l					
hotelnya	h o t e l ny a					
hr	e ɪ ʧ ɑr					
image	i m e j					
ini	i n i					
intern	i n t E r n					
internnya	i n t E r n ny a					
isu	i s u					
itu	i t u					
iya	i y a					
jadi	j a d i					
jadinya	j a d i ny a					
jalan	j a l a n					
jangan	j a ng a n					
juga	j u g a					
kadar	k a d a r					
kalau	k a l au					
kalian	k a l i a n					
kamu	k a m u					
kan	k a n					
kandungan	k a n d u ng a n					
karna	k a r n a					
kasih	k a s i h					
katanya	k a t a ny a					
kaya	k a y a					
kayanya	k a y a ny a					
ke	k E					
kemarin	k E m a r i n					
kenapa	k E n a p a					
kerjain	k E r j ai n					
keuangan	k E u a ng a n					
kinerja	k i n E r j a					
kira	k i r a					
kita	k i t a					
kompatibel	k o m p a t i b e l					
kos	k o s					
kosan	k o s a n					
kucing	k u c i ng					
kucingnya	k u c i ng ny a					
kura	k u r a					
lagi	l a g i					
lagian	l a g i a n					
lah	l a h					
lahiran	l a h i r a n					
lain	l ai n					
lama	l a m a					
langsung	l a ng s u ng					
lanjut	l a n j u t					
laporan	l a p o r a n					
laporannya	l a p o r a n ny a					
lewat	l e w a t					
liat	l i a t					
lihat	l i h a t					
linknya	l i n k ny a					
loadingnya	l o a d i ng ny a					
local	l o c a l					
loh	l o h					
lupa	l u p a					
maaf	m a a f					
maap	m a a p					
mah	m a h					
main	m ai n					
makanan	m a k a n a n					
makanannya	m a k a n a n ny a					
makasih	m a k a s i h					
maksudnya	m a k s u d ny a					
males	m a l E s					
manager	m e n e j e r					
mas	m a s					
masa	m a s a					
masuk	m a s u k					
masukin	m a s u k i n					
mau	m au					
meeting	m i t i ng					
meetingnya	m i t i ng ny a					
membuat	m E m b u a t					
memperbaiki	m E m p E r b ai k i					
menemukan	m E n E m u k a n					
mentang	m E n t a ng					
merhatiin	m E r h a t i i n					
minggu	m i ng g u					
minta	m i n t a					
money	m a n i y					
mulai	m u l ai					
muncul	m u n c u l					
mungkin	m u ng k i n					
nah	n a h					
nanti	n a n t i					
ngada	ng a d a					
ngajuin	ng a j u i n					
nge	ng E					
ngerjain	ng E r j ai n					
ngetes	ng E t e s					
ngomong	ng o m o ng					
ngumpulin	ng u m p u l i n					
nih	n i h					
nilai	n i l ai					
noted	n o t i d					
notifikasi	n o t i f i k a s i					
nunggu	n u ng g u					
nutrisi	n u t r i s i					
nutrisinya	n u t r i s i ny a					
nyari	ny a r i					
nyebrang	ny E b r a ng					
nyelesaiin	ny E l E s ai i n					
nyempetin	ny E m p E t i n					
nyisihin	ny i s i h i n					
oh	o h					
oke	o k e					
on	o n					
orang	o r a ng					
otomatisasi	o t o m a t i s a s i					
pagi	p a g i					
pakai	p a k ai					
paling	p a l i ng					
pas	p a s					
pasti	p a s t i					
pembahasan	p E m b a h a s a n					
pembayaran	p E m b a y a r a n					
pemesanan	p E m E s a n a n					
pencari	p E n c a r i					
penggunanya	p E ng g u n a ny a					
penjual	p E n j u a l					
penting	p E n t i ng					
penyimpanan	p E ny i m p a n a n					
perkembangannya	p E r k E m b a ng a n ny a					
perlu	p E r l u					
pesan	p E s a n					
pesen	p E s E n					
pintunya	p i n t u ny a					
progres	p r o g r e s					
project	p r o j e c t					
pulih	p u l i h					
punya	p u ny a					
quality	k u a l i t i					
recognition	r i k o g n i s y e n					
rekomendasi	r e k o m e n d a s i					
rekomendasinya	r e k o m e n d a s i ny a					
rencana	r E n c a n a					
rencananya	r E n c a n a ny a					
review	r i v i e w					
sama	s a m a					
sampai	s a m p ai					
sampe	s a m p e					
sana	s a n a					
satu	s a t u					
saya	s a y a					
searching	s e r c h i ng					
sebelah	s E b E l a h					
sebelas	s E b E l a s					
sebelum	s E b E l u m					
sebelumnya	s E b E l u m ny a					
seberapa	s E b E r a p a					
sehat	s e h a t					
sekali	s E k a l i					
sekaligus	s E k a l i g u s					
sekaligusnya	s E k a l i g u s ny a					
sekarang	s E k a r a ng					
selalu	s E l a l u					
selesai	s E l E s ai					
sementara	s E m E n t a r a					
seminggu	s E m i ng g u					
semoga	s E m o g a					
semua	s E m u a					
semuanya	s E m u a ny a					
sendiri	s E n d i r i					
sepuluh	s E p u l u h					
server	s E r v E r					
setelah	s E t E l a h					
siapa	s i a p a					
sih	s i h					
sistem	s i s t E m					
soalnya	s o a l ny a					
sudah	s u d a h					
supaya	s u p a y a					
support	s u p p o r t					
supportnya	s u p p o r t ny a					
susah	s u s a h					
tadi	t a d i					
tapi	t a p i					
tau	t au					
temen	t E m E n					
tempat	t E m p a t					
terakhir	t E r a kh i r					
terima	t E r i m a					
terlambat	t E r l a m b a t					
terus	t E r u s					
testing	t e s t i ng					
testingnya	t e s t i ng ny a					
tidak	t i d a k					
tiga	t i g a					
tiket	t i k e t					
tim	t i m					
tinggal	t i ng g a l					
transfer	t r a n s f E r					
tungguin	t u ng g u i n					
udah	u d a h					
unicorn	u n i c o r n					
untuk	u n t u k					
update	a p d e t					
updatenya	a p d e t ny a					
versi	v e r s i					
virtual	v i r t u a l					
waduh	w a d u h					
waktu	w a k t u					
waktunya	w a k t u ny a					
wisata	w i s a t a					
ya	y a					
yang	y a ng					
yaudah	y au d a h					
zaman	z a m a n					