acara	a c a r a
ada	a d a
adalah	a d a l a h
adapun	a d a p u n
administrasi	a d m i n i s tr a s i
agak	a g a k
agar	a g a r
agenda	a g e n d a
akan	a k a n
akhir	a kh i r
analisis	a n a l i s i s
anda	a n d a
apa	a p a
apakah	a p a k a h
aplikasi	a p l i k a s i
ardan	a r d a n
aryasa	a r y a s a
asalkan	a s a l k a n
atas	a t a s
atau	a t au
ataupun	a t au p u n
bagaimana	b a g ai m a n a
bagi	b a g i
bagian	b a g i a n
bagus	b a g u s
bahas	b a h a s
bahwa	b a h w a
baik	b ai k
baiklah	b ai k l a h
banyak	b a ny a k
bapak	b a p a k
barang	b a r a ng
beberapa	b e b e r a p a
begitu	b e g i t u
bekerja	b e k e r j a
belanja	b e l a n j a
beliau	b e l i au
belum	b e l u m
benar	b e n a r
berada	b e r a d a
berbicara	b e r b i c a r a
berdasarkan	b e r d a s a r k a n
beri	b e r i
berikan	b e r i k a n
beristirahat	b e r i s t i r a h a t
berjalan	b e r j a l a n
berkaitan	b e r k ai t a n
berkembang	b e r k e m b a ng
berkumpul	b e r k u m p u l
beroperasi	b e r o p e r a s i
berpendapat	b e r p e n d a p a t
bersaing	b e r s ai ng
bersama	b e r s a m a
berusaha	b e r u s a h a
besar	b e s a r
biasanya	b i a s a ny a
bila	b i l a
bisa	b i s a
boleh	b o l e h
bukan	b u k a n
bukankah	b u k a n k a h
busono	b u s o n o
cantika	c a n t i k a
cara	c a r a
caranya	c a r a ny a
cenderung	c e n d e r u ng
cepat	c e p a t
coba	c o b a
cukup	c u k u p
cukupkan	c u k u p k a n
dalam	d a l a m
dan	d a n
dana	d a n a
dapat	d a p a t
dari	d a r i
darurat	d a r u r a t
data	d a t a
dava	d a v a
delapan	d e l a p a n
demikian	d e m i k i a n
dengan	d e ng a n
di	d i
dibahas	d i b a h a s
diberikan	d i b e r i k a n
dibiarkan	d i b i a r k a n
dibicarakan	d i b i c a r a k a n
dibutuhkan	d i b u t u h k a n
dihentikan	d i h e n t i k a n
dikatakan	d i k a t a k a n
dikeluhkan	d i k e l u h k a n
diketahui	d i k e t a h u i
dikurangi	d i k u r a ng i
dilakukan	d i l a k u k a n
dilanjutkan	d i l a n j u t k a n
dimaafkan	d i m a a f k a n
diminati	d i m i n a t i
dimulai d i m u l ai
diproduksi	d i pr o d u k s i
disampaikan	d i s a m p ai k a n
disetujui	d i s e t u j u i
diskon	d i s k o n
distributor	d i s tr i b u t o r
divisi	d i v i s i
dua	d u a
dulu	d u l u
ecommerce	i k o m e r s
efektif	e f e k t i f
empat	e m p a t
enam	e n a m
esa	e s a
facebook	f e i s b u k
faktor	f a k t o r
fokus	f o k u s
gudang	g u d a ng
hadir	h a d i r
hadirat	h a d i r a t
hal	h a l
hanya	h a ny a
harapan	h a r a p a n
hardoyo	h a r d o y o
harga	h a r g a
harganya	h a r g a ny a
hari	h a r i
harus	h a r u s
hasil	h a s i l
hormati	h o r m a t i
ibu	i b u
ide	i d e
imel	i m e l
ingin	i ng i n
ini	i n i
insinyur	i n s i ny u r
instagram	i n s t a gr a m
internal	i n t e r n a l
inti	i n t i
itu	i t u
itulah	i t u l a h
iya	i y a
izin	i z i n
jadi	j a d i
jadwal	j a d w a l
jangkauan	j a ng k au a n
jawab	j a w a b
jika	j i k a
jual	j u a l
juga	j u g a
jumlah	j u m l a h
kalau	k a l au
kali	k a l i
kami	k a m i
karena	k a r e n a
karyawan	k a r y a w a n
kasih	k a s i h
katakan	k a t a k a n
ke	k e
keadaan	k e a d a a n
kedepannya	k e d e p a n ny a
kegiatan	k e g i a t a n
keluhan	k e l u h a n
keluhannya	k e l u h a n ny a
kembali	k e m b a l i
kendala	k e n d a l a
kepada	k e p a d a
kepala	k e p a l a
kepenuhan	k e p e n u h a n
keputusan	k e p u t u s a n
kerja	k e r j a
kesalahan	k e s a l a h a n
kesempatan	k e s e m p a t a n
kesempatannya	k e s e m p a t a n ny a
ketahui	k e t a h u i
ketahun	k e t a h u n
ketika	k e t i k a
keuangan	k e u a ng a n
keuntungan	k e u n t u ng a n
kian	k i a n
kinaya	k i n a y a
kinerja	k i n e r j a
kita	k i t a
klien	k l i e n
kondisi	k o n d i s i
konsumen	k o n s u m e n
konten	k o n t e n
kredibilitas	kr e d i b i l i t a s
kualitas	k u a l i t a s
kurang	k u r a ng
lagi	l a g i
lain	l ai n
lainnya	l ai n ny a
laku	l a k u
lakukan	l a k u k a n
lalu	l a l u
lancar	l a n c a r
langsung	l a ng s u ng
lanjut	l a n j u t
lapangan	l a p a ng a n
laporan	l a p o r a n
lazada	l a z a d a
lebih	l e b i h
liburan	l i b u r a n
lima	l i m a
maaf	m a a f
macam	m a c a m
maha	m a h a
maju	m a j u
maka	m a k a
manajer	m e n e j e r
marilah	m a r i l a h
masa	m a s a
masalah	m a s a l a h
masih	m a s i h
masing	m a s i ng
media	m e d i a
melakukan	m e l a k u k a n
melalui	m e l a l u i
melampaui	m e l a m p au i
melaporkan	m e l a p o r k a n
memakai	m e m a k ai
memang	m e m a ng
membacakan	m e m b a c a k a n
membahas	m e m b a h a s
membantu	m e m b a n t u
membeli	m e m b e l i
membentuk	m e m b e n t u k
memberi	m e m b e r i
memberikan	m e m b e r i k a n
membuat	m e m b u a t
memfokuskan	m e m f o k u s k a n
memperbarui	m e m p e r b a r u i
memperluas	m e m p e r l u a s
memproduksi	m e m pr o d u k s i
mempromosikan	m e m pr o m o s i k a n
menambahkan	m e n a m b a h k a n
menampung	m e n a m p u ng
menang	m e n a ng
menarik	m e n a r i k
mendapat	m e n d a p a t
mendekati	m e n d e k a t i
mendiskusikan	m e n d i s k u s i k a n
mengajukan	m e ng a j u k a n
mengakhiri	m e ng a kh i r i
mengalami	m e ng a l a m i
mengatasi	m e ng a t a s i
mengetahui	m e ng e t a h u i
menggunakan	m e ng g u n a k a n
menghentikan	m e ng h e n t i k a n
menghubungi	m e ng h u b u ng i
mengingat	m e ng i n  a t
mengkhawatirkan	m e ng kh a w a t i r k a n
mengurangi	m e ng u r a ng i
mengurusi	m e ng u r u s i
meningkatkan	m e n i ng k a t k a n
menjalin	m e n j a l i n
menjual	m e n j u a l
menunjukkan	m e n u n j u k k a n
menurun	m e n u r u n
menurunnya	m e n u r u n ny a
menurut	m e n u r u t
menyampaikan	m e ny a m p ai k a n
menyebabkan	m e ny e b a b k a n
menyela	m e ny e l a
menyempit	m e ny e m p i t
mesin	m e s i n
meskipun	m e s k i p u n
mestinya	m e s t i ny a
miliki	m i l i k i
minat	m i n a t
minimalis	m i n i m a l i s
mohon	m o h o n
monoton	m o n o t o n
mudah	m u d a h
mulai	m u l ai
namun	n a m u n
nanti	n a n t i
nya	ny a
oleh	o l e h
omzet	o m z e t
online	o n l ai n
pada	p a d a
pagi	p a g i
pak	p a 
pakai	p a k ai
panjatkan	p a n j a t k a n
para	p a r a
pasar	p a s a r
pekerja	p e k e r j a
pemasaran	p e m a s a r a n
pembahasan	p e m b a h a s a n
pembeli	p e m b e l i
pembersihan	p e m b e r s i h a n
pembukaan	p e m b u k a a n
pendapat	p e n d a p a t
penelitian	p e n e l i t i a n
pengarahan	p e ng a r a h a n
peningkatan	p e n i ng k a t a n
penjelasannya	p e n j e l a s a n ny a
penjualan	p e n j u a l a n
penurunan	p e n u r u n a n
penutup	p e n u t u p
penyebabnya	p e ny e b a b ny a
perawatan	p e r a w a t a n
perlu	p e r l u
permasalahan	p e r m a s a l a h a n
permintaan	p e r m i n t a a n
persen	p e r s e n
persilakan	p e r s i l a k a n
personalia	p e r s o n a l i a
pertama	p e r t a m a
pertimbangkan	p e r t i m b a ng k a n
perusahaan	p e r u s a h a a n
pesaing	p e s ai ng
pihak	p i h a k
pilih	p i l i h
pilihan	p i l i h a n
pimpinan	p i m p i n a n
populer	p o p u l e r
potongan	p o t o ng a n
produk	pr o d u k
produksi	pr o d u k s i
promosi	pr o m o s i
proposal	pr o p o s a l
proses	pr o s e s
puji	p u j i
puluh	p u l u h
rapat	r a p a t
rasa	r a s a
rencana	r e n c a n a
saat	s a a t
saja	s a j a
salam	s a l a m
sama	s a m a
sampai	s a m p ai
sampaikan	s a m p ai k a n
sangat	s a ng a t
saran	s a r a n
satu	s a t u
satunya	s a t u ny a
saya	s a y a
sebagai	s e b a g ai
sebagaimana	s e b a g ai m a n a
sebagainya	s e b a g ai ny a
sebaiknya	s e b ai k ny a
sebanding	s e b a n d i ng
sebelum	s e b e l u m
sebelumnya	s e b e l u m ny a
sebenarnya	s e b e n a r ny a
sebesar	s e b e s a r
secara	s e c a r a
sedang	s e d a ng
sedangkan	s e d a ng k a n
sedikit	s e d i k i t
segala	s e g a l a
segera	s e g e r a
segi	s e g i
sehat	s e h a t
sehingga	s e h i ng g a
sejahtera	s e j a h t e r a
sejenis	s e j e n i s
sekali	s e k a l i
sekalian	s e k a l i a n
sekarang	s e k a r a ng
sekretaris	s e kr e t a r i s
selain	s e l ai n
selaku	s e l a k u
selalu	s e l a l u
selama	s e l a m a
selamat	s e l a m a t
selanjutnya	s e l a n j u t ny a
semakin	s e m a k i n
semangat	s e m a ng a t
sembilan	s e m b i l a n
sementara	s e m e n t a r a
semoga	s e m o g a
semua	s e m u a
semuanya	s e m u a ny a
sentosa	s e n t o s a
sependapat	s e p e n d a p a t
seperti	s e p e r t i
sepertinya	s e p e r t i ny a
sepuluh	s e p u l u h
serahkan	s e r a h k a n
sering	s e r i ng
serta	s e r t a
servis	s e r v i s
sesuai	s e s u ai
sesuatu	s e s u a t u
setelah	s e t e l a h
setiap	s e t i a p
setuju	s e t u j u
shopee	sy o p i
siang	s i a ng
signifikan	s i g n i f i k a n
sosial	s o s i a l
stabil	s t a b i l
strategi	s tr a t e g i
sudah	s u d a h
supplier	s u p l a y e r
susun	s u s u n
syukur	sy u k u r
syukurlah	sy u k u r l a h
tadi	t a d i
tahun	t a h u n
tahunan	t a h u n a n
tama	t a m a
tampung	t a m p u ng
tanggung	t a ng g u ng
tanya	t a ny a
tapi	t a p i
target	t a r g e t
terakhir	t e r a kh i r
terawat	t e r a w a t
terbaik	t e r b ai k
tercapai	t e r c a p ai
terdapat	t e r d a p a t
terhadap	t e r h a d a p
terima	t e r i m a
terjadi	t e r j a d i
terjangkau	t e r j a ng k au
terjual	t e r j u a l
terkait	t e r k ai t
ternyata	t e r ny a t a
tersebut	t e r s e b u t
tersedia	t e r s e d i a
terselamatkan	t e r s e l a m a t k a n
tersimpan	t e r s i m p a n
terus	t e r u s
tetap	t e t a p
tetapi	t e t a p i
tidak	t i d a k
tiga	t i g a
tim	t i m
tindakan	t i n d a k a n
tingkat	t i ng k a t
tokopedia	t o k o p e d i a
tuhan	t u h a n
tujuan	t u j u a n
tujuh	t u j u h
turun	t u r u n
untuk	u n t u k
usul	u s u l
versi	v e r s i
visual	v i s u a l
wacanakan	w a c a n a k a n
waktu	w a k t u
waktunya	w a k t u ny a
yaitu	y ai t u
yang	y a ng
